w w w w w w w w w
w p w 0 w d w 0 w
w 0 0 s d 0 d d w
w 0 w 0 w d w g w
w w w w w w w w w