w w w w w w w w 0
w p w 0 0 0 w s w
w 0 0 0 w 0 w 0 w
w w d w w 0 0 0 w
w w s w w w w w w
w w 0 d d 0 0 g w
w w w w w w w w w